1111111111111111111111111
1010000010101000001010101
1111101110101111101010101
1020000000000000001010101
1011101011111210111011111
1010101000100010000000001
1010101010111110111011111
1010000010000010001000001
1110111110111011101111101
1000100000100010001000101
1111111111111111111111111