111111111111111111111
101000002000000000001
111020002000001111101
101001100010021000101
201010111000101010101
200000101000101010102
100000111000101010101
100000200000100010001
100100000100100010001
111111111111111111111